With the grace of the Gods	Kravnia greshterma dæ Vosedyvia’
the autocrats	utakratsier’
and the people	a hersona’
vov gesdovana noron	wow so big
Ma kapaznarovska vokta!	I'm just kidding!
all will hail His Majesty	sedyvia raduznakriya Præstova esa Vasavalezestva
second of the House of Sirezia	Kavaes dæ Kosovno dæ Sirezia
third to the ascending of the Great Kingdom of Prasvulsia	Kesta podyemarovska dæ Vesenea Veleka dæ Prasvulsea
King Syros of Sirezia	Vesedyvia Seros dæ Sirezia
As the procession continued	Mas pradenye kontedyviætashk
there came before the great hall of the palace	tadyvia sumatshk ukraza qhorzæ veleka dæ valæsæa
From across the seas beyond the reach of the Sirezians came diplomats from kingdoms far in the west and the north	otrozka’ dæ vota’ dæ posesion’ veleka a rasnoy aslanda
Eshvesta	Meanwhile / At the same time
Yarvesta	A lot / Much
Dosanyo	A little bit
Dosanya	A lot
Saprodyviæt	Godspeed / Good luck
Yatkaukradyviaska	Pull yourself together
Sapruzna	For God’s sake
Pradozska	Go on / Spill the beans / Fire away
Kakaraseshta	Why does it matter / What difference does it make / Why do you care
Fashto	The fact that / To think that
Grosovna	Yay
Præsovno	Too late
Putamoztu	As a result of / Because of / Thus
Tasnavashka	Technically / In truth
Ushta	It’s okay / Fine
Kazena	Years old
Soglazno	According to
Avarovas	Ahead of
Esedyvia	Instead of
Meznaprozæm	By the way
Uzaena	In case
Yaraduzov	I don’t care
Da	Oh
Enleshtav	Finally
Sprozna	Of course
Vedema	Greetings
Suyasta	Go on
Uzmatesha	In my opinion
Pavenauzasnæ	Doing nothing is better than doing a negative
Sevasav	Really / Truly
Sakrozna	Shut up
Nostosh	Very well
Koroyena	As well / Too
Danesvritadyvia	Shut the fuck up
Toshenye	What’s up / What’s going on
Salæ	So be it
Zarpazo	Give up
Mas	As / During the same time
Yarvedyvien	Looks/Sounds like
Yesvedyviæto	I can’t believe it / What the heck
Makuzasnavkasenkontrakriyost	I will either find a way or make one
Arænayvrolovasheveatodyviadyvieaksonazazerbrantoyespandyvievrashenye	Raise your words, not your actions, for it is rain that makes plants grow, not thunder.
Zaprosto	Do tell / I encourage you
Prashut	Ouch / Ow
Avedyvia	About
Æzna	From
Akseo	Above
Azq	Across
Arvedyvia	Against
Kasia	Along
Kavidyvia	Among
Avronadyvia	Around
Vaesmo / It	At
Bareshna	Behind
Velbesma	Below
Sarma	Beneath
Sarzasta	Beside
Mætrasha	Belong
Velmqta	Between
Suronyas	Beyond
Kalesmo	By
Nq	Down
Duvroska	During
Dazenska	Despite
Uza	In
Uzasta	Inside
Uzarov	In to / Into
Morovka	Near
Esma	Off
On	Es
Esov	On to / Onto
Esovra	Out
Esyarenva	Outside
Sushda	Over
Sklaven	Past
Deava	Through
Deavesovra	Throughout
Uzfas	Upon
Kravnia	With
Kravnoyuza	Within
Kravnoyoska	Without
Abashdone	Abroad
Soglazno	According to
Avarovas	Ahead of
Morofska	Apart / A part
Kalva	Aside
Esedyvia	Instead of
Veltasealo	Opposite
Ov	To
Ovaronyas	Toward/ Towards
Umbar	Under
Umbaronyas	Underneath
Unbar	Until
Unas	Up
Vesnova	Concerning…
Dæ	Of
Uvyost	1
Kavaes	2
Kesta	3
Feore	4
Feoros	5
Sevuy	7
Altodyvio	8
Dyvievan	9
Uvanyost	11
Kavaenyas	12
Kesyasta	13
Feorias	14
Feoroseo	15
Siyashasto	16
Sevoyas	17
Alasyanto	18
Dyvievadyvios	19
Karanesfo	20
Karasuvos	21
Karvedyvias	22
Karvedyvio	23
Karvensha	26
Karvuydæva	27
Kasalanto	28
Karadyviæva	29
Kætrano	30
Kætumana	31
Kætanas	32
Katermas	33
Ketorme	34
Ketoros	35
Kesasha	36
Kevuy	37
Ketodyvio	38
Ketevadyvia	39
Kezæena	40
Ferasuvos	41
Feraes	42
Feranyas	43
Fetromos	44
Fesasha	45
Ferasha	46
Ferasevuy	47
Feradyvio	48
Feradyvia	49
Feorodyvievan	50
Feoruvos	51
Feorskava	52
Feorskeva	53
Feorskias	54
Feorosta	55
Feorsha	56
Feorvuy	57
Feorodyvio	58
Feorodyvieva	59
Sæeshta	60
Sæuvos	61
Sævaes	62
Sæeshyas	63
Særenræ	64
Sæoros	65
Sæeshanta	66
Esa	Is / Am / Are
Vesara	Was / Were
Ozka	Can
Uzos / Yunashka	Be
Æto	Have / Has
Shvasta	Should
Velkradyvia	Would
Moga	Could
Mavrata	Do / Does
Veneta	Might
Vraskasma	Must
Mozætæ	May
Dyvieovra	For / Because
A	And
Sevroma	But / Yet
Noron / Tak	So
Kasa	Or
Fal	If
Alphabet	Idahabæn
At	It
After	Astera
Any / Anyone	Tus
All	Sedyvia / Shtol
Act	Darvedyvia
Authority	Atoredyvia
Army	Varsia
Afternoon	Asterovsa
Always	Varadyvia
Almost	Shvianta
Avalanche	Saravska
Arrest	Varodyvievos
Also	Asla
Ago	Anta
Anger	Karveza
Angry	Armena
Anyways / Anyhow / Anywho	Tusavna
Advise / Advice	Vazesta
Adviser	Vazer
Autocrat	Utakratsier
Afflict	Vostovas
Air	Era
Amaze	Gasadarena
Ass	Seshka
Anything	Notusdyvio
Armada	Armadadyvia
Art	Atesta
April	Abrandomozka
August	Augustusamozka
Afford	Afento
Answer / Solution	Vostaza
Author	Zotrozka
Add	Dobavet
Active	Aktevna
Account	Shvot
Announce	Dyviata
Admit	Sprasheva
Already	Uzæ
Again	Arvos / Raseska / Aseyanto
Assemble / Arrange	Ustravæta
Able	Spasovna
Advantage	Advantoshka
Attack	Atozka
Annoy / Irritate	Razesna
Arrogant	Slushæna
Appear	Vosnatsa
Attention	Atentoshka
Angel	Angyel / Anyel
Accuse	Akasna
Absurd	Vena
Accent	Gostova
Agree	Zopra
Arbitrary	Arbezana
Approximate	Aproksemata
Appropriate	Apropriato
Awkward	Ozto
Affect / Effect	Akaznoyas
Ascend	Podyema
Approach	Pokoda
Amuse	Rasnedyvie
Adult	Adulto
Adultery	Adultreo
Analysis	Analeteko
Anthem	Antem
Allow / Permit	Razeska
Amount	Sorogat
Appeal / Cater	Zavaras
Assimilate	Yesmedyvio
Better	Aksenyo
Best	Aksenya
Before / Beforehand	Ukraza
Being [n.]	Veltrega
Born / Birth	Kesta / Muvros
Brown	Vakranda
Beach	Sarovdyvia
Bad	Volesmo
Bless	Baglosavet
Baby	Dyviepron
Bye	Sveadyvia
Bore	Serana
Business	Breshefta
Boy	Havraena
Boast	Moyasa
Both	Asva
Bitch	Viyeta
Base	Osnovas / Grasesva
Big	Gesdovana
Beauty	Vretasna
Boundary	Kasadyvia
Build	Tusa
Bring	Gesda
Battle	Vitasa
Box	Boza
Ballot	Voltesbera
Bullet	Valan
Back	Anva
Burn	Vedavna
Book	Vozka
Begin / Start	Nazena
Believe	Na / Vashevusdevna
Basic	Utra
Bilingual	Yaskrezna
Bed	Dorma
Bedroom	Yorinadorma
Bag	Sumka
Behavior	Uslovna
Benevolent	Dovrazema
Bait	Biashna
Body	Ovronanta
Basilisk	Baselesko
Bastard	Bastardo
Brother	Bratoshka
Black	Vazno
Bird	Herato
Bitter	Ozestazone
Bible	Beblo
Bonus	Hronesto
Blood	Sangrano
Benefit	Prazedo
Balance	Baldyvietsa
Core	Korva
Complacent	Sakandor
Cease / Seize	Aksestidyvia
Conscience	Kalvera
Common	Komenost
Continue / Proceed	Muyesvosta / Kontedyviæta
Combine	Karæshta
Collect	Turona
Care	Voldyviet
Come	Lesarma / Sumat
Cross	Kros
Continent	Anastva
Crown	Korona
Conquest	Konesta
Congrats	Sashela
Change / Manipulate / Modify / Edit	Usla / Esmedyviæta
Curse	Zoksama
Control	Esanost
Conceal	Kosan
Close	Seserma
Crust	Duma
Call	Dæs / Vrosa
Curtain	Kevadyvio
Chaos	Desberanto
Constant / Relative	Vetarna
Courage	Soraza
Cry	Titadyvia
Crush	Zedema
Cool	Seska / Paznevneka
Cold	Koza
Caution	Torvato
Current	Tuzkæ
Calamity	Mesazera
Cow	Sovena
Complete / Finish	Zikanza
Corrupt	Votrægar
Cute	Kona
Country	Valdyvietsa
Crazy / Insane	Vestuza
Carry	Dyviæsta
Child / Kid	Suzda
Company	Gasudærena
Consider / Count / Factor	Zetia / Svomada
Cook	Yanyæ
Cruel	Zaprosh
Clock	Vosh
Capable	Razuva
Content	Sovraza
Conjugation	Spazenye
Command	Komand
Consist / Comprise	Kozesto
Chance	Shansna
Calculate	Kakashna
Cunning	Væstusha
Clothes / Clothe	Kotoga
Coil	Koyas
Capsulate / Encapsulate	Kapozna
Certain / Definite / Definitive	Nædozna
Cut	Kon
Capital	Kostala
Coronate	Koronasa
Ceremony / Procession	Pradenye
Chair	Sodyviæva
Chest	Zærovæ
Correct	Pravene
Commit	Harmeto
Covet	Zasna
Chapter	Kapetulo
Convey / Send	Opravena
Clear	Zesto
Circa	Serka
Choir	Qheor
Channel	Shta
Constituion [n]	Konstetusion
Charge	Aflado
Contact	Kontakto
Catch	Festo
Cardio	Kardo
Card	Katoshka
Century	Senturos
Culture	Kultura
Coordinate	Kordenato
Customer	Kustomer
Cloud	Krotovo
Consent	Skashu
Congress	Shtravetenye
Citizen	Zevenye
Cheapskate	Zæprazna
Cartwheel	Krugoy
Calm	Domo
Dictionary	Davroma
Doubt	Bavarov
Die	Vædema
Drama	Darma
Dignity	Tuvrodyvia
Dog	Varmo
Destroy / Break	Vasleshta
Dispute	Unveyan
Defy	Vradema
Dream	Viar
Day / Today	Dadyvio
Deliver	Hasanso
Drink	Trenkun
Deep	Dyvieva
Damn	Verda
Diaper	Usadyvias
Decide / Choose	Merba
Defer	Defera
Dry	Sovan
Dictator	Dektator
Drop	Tros
Discord	Vestorna
Despair	Desbatordyvia
Determine	Eshtera
Danger / Endanger	Opazne
Dare	Sæzarmeas
Diacritic	Deakreto
Dead / Death [n]	Væskema
Devil	Diabla
December	Davradyviomozka
Direct	Derakta
Different	Vumada
Diplomacy	Deplomate
Dialect	Dealekt
Dumb	Prazevneka
Desk	Vroyozka
Discipline	Desevna
Dismay	Skaza
Distance	Destonsna
Divide / Separate [v.]	Razena
Division  [army]	Deveseon
Division [math]	Razenav
Deliberate	Ratosh
Deceive	Esmedyvia
Disorder	Dyviormeta
Device	Devasæ
Divulge	Devoshta
Defeat	Vremdyvia
Dragon	Dragona / Dragon
Dance	Dansa / Vorovka
Declare	Deklarata
Deputy / Senior	Devushna
Define	Defena
Discourse	Deskosna
Daughter	Dozna
Destination	Destonasia
Debt	Dæto
Deny	Otretsat
Depend	Zavesesto
Date	Deanto
Document [n]	Dokumento
Document [v]	Svædashna
Dinner	Yenor
Defense	Diyando
Due	Mæna
Dexterity / Ambidexterity	Vreatsko
Democracy	Demokratia
Every / Everyone	Kazdæ
Endow	Vratuv
Example	Estarusa
Emperor	Emperator
Empress	Emperatretsa
Enough	Brishadyvia
Exact	Stoy
Evil	Val
Earth	Kosorovnea
Eat	Greshna
Enemy	Evandosa
Empire	Emparatretsea
End	Vedyvia / Krazenza
Economics	Ekanamaska
East	Esla
Early	Sesma
Explode	Vrustiadyvia
Easy / Ease	Astias
Employ	Damenanta
Even	Evoyas
Exercise	Eksesta
Error	Kerado
Eternity	Eterna
Either	Kazda
Element	Elemanta
Else	Dormia
Except	Asklamadyvia
Entire / Overall	Enterana
Equal	Gravna
Empty	Enfetala
Ever	Soza
Each	Poza
Enjoy	Bræstol
Especially	Osobena
Expand	Rashedyviæ
Equipment / Tool / Supply	Ovtramena
Entice / Allure / Lure	Kuzaznæ
Evade	Yævara
Expect	Pazqmia
Eunich	Unek
Eye	Oyo
Emphasize	Harodyviovæt
Evoke	Emdyviæna
Evocation	Evokasion
Establish	Æstashna
Encourage	Eroyena
Explore	Esledyvioano
Falcon	Zaza
Fight	Varzasa
Fool	Fuze
Free	Agraedyvio
Freedom	Agraena
Fate	Sutka
Fox	Zamantov
Fruit	Fratadyvia
Fair	Senkenta / Fera
Full	Avyna
Fall	Unvresma / Zedena
Feel	Amatos
Farm	Areshna
Father	Vodyvio
Fat	Barovna
Face	Zaustka
Favorite	Favorena
Fuck	Vokta
Far	Barmo
Fake	Vatka
False	Vatkan
Few	Vulsha
Fester	Kestama
Foreign	Aslanda
Facade	Bratia
Faith	Fædyvia
Front	Vosduzna
Find	Enkontra
Friend	Vasanter
Fun	Vasterma
Federation	Federeska
Fallacy	Falasia
Fast	Esvosando
Family	Sevena
Function	Funshtion
Flower	Svadoshvanta
Flame	Flama
Fire	Ferda
Final / Last	Enleshta
Form / Develop	Feærma
February	Fehanmozka
Freeze	Koladyvia
Fact	Falasma
Force [v]	Voska
Force [n]	Voskas / Forsas
Forever	Nagsezda
Follow / Subscribe	Kasdozna
Funny	Sproshka
Focus	Sezas
Fill	Napoldyviat
Forgive	Vuhansev / Pristet
Feign / Talk	Nastraza
Fantastic	Dusno
Flank	Flanka
Field	Feanto
Favor	Utozna
Fortunate	Prodasna
Forget	Siyato
Fear	Strq
Fame	Harmosto
Folk	Narodyvie
Fierce	Veando
Famous / Popular	Shnatoyu
Flood / Drown	Dyviapron
Future	Menye
Friday	Frendo
Formal	Prastoy
Grammar	Geshundit
Good	Dosva
Good [n]	Gos
Go	Suyas
Give / Submit	Pozda / Brasto
Get / Gain	Atem / Hazosva / Veshæ
Girl	Shvaena
Grand	Varmakia / Grandæ
Great / Prominent	Hasenske / Veleka
Grace	Greshterma / Zahansk
Grape	Emaseska
Glow	Vastos
God	Vosedyvia
Game	Tuvana
Gun	Gunda
Guarantee / Promise	Garantia
Goal / Purpose	Moyasta
Graph	Grasesma
Ground	Grasevsna
General	General
Green	Vadamar
Glass	Vasonvastashka
Group / Array	Udyviana
Grab /  Grasp /Touch	Graspo
Grow	Espando
Grin	Osta
Gold	Verdana
Greet	Vema
Glory	Slava
Gentle	Neaznæ
Grade	Hrastov
He / Him / His	Hasa / Præstova
Human	Ovarena
Hi / Hello	Hastva
Hate	Mesarva
How	Vas / Dyviæta
Holy	Vranyando
House	Kosovno
Haste	Grodyvia
Here	Adyvia
History	Ventalo
Happy	Varasta
Hope	Alosæ
Happen	Brastdyvia
Heavy	Kenava
Hurry	Venenta
Harmony	Armana
Honor	Sovashka
Help	Yavrasena
Heaven	Hevan
Hell	Hesvanto / Enfernal
Hot / Heat	Ovrazema
Hail	Raduzna / Helva
Handwriting	Egrata
Hear / Sound	Sleshnu
Helping Verb / Auxiliary verb	Vomadayavrasa
Head	Glavna
Hence	Kokarashesæsama
Hold	Skatashna
Hospital	Hospetal
Hard / Difficult	Terozna
Hall	Qhorzæ
Hand	Egoro
Hurt	Provenye
Heart	Harason
Heal / Recover	Vostana
Hymm	Hem
Humble	Soromna
Hint	Namækanto
Highlight	Andozna
High	Hando
Humor	Yanyando
Honest	Hernas
Health	Drovoy
It	At
I / Me / My / Mine	Ma / Meæt
Influence	Navradovska
Iron	Iron / Irona
Imperial	Emberskiya
Imperium	Emperosa
Instance	Enstansa
Impossible	Ensasadyvia
Illusion	Elosiæv
Isolate	Esola
Infidel	Enfeal
Idiot	Eskadyvio
Inspire	Enberadyvia
Information / Info	Enformatsa
Incumbent	Vozenzando
Invade	Envada
Inform / Update	Postavet
Improve	Vaznæ
Interjection	Mezdemeatsa
Island	Arvana
Introduction	Entrodosia
Introduce	Entrodusa
Inflate	Enflat
Inflation	Enflatsion
Important	Emportantæ
Ignore / Neglect	Egnora
Ignite	Egneta
Insignia	Ensedyviæta
Impose	Emprosa
Interest	Entereso / Zaprozno
Jump	Esun
Journal	Zenala
Just	Velek / Seran
January	Yahanmozka
June	Væmozka
July	Zulamozka
Judge	Vrushna
Join	Ferasovo
Involve	Zepredyvie
Know	Kasedyvia
King	Vasedyvia
Kingdom	Vesenea
Kind	Zazanto
Kill	Kasama
Keyboard	Keoabred
Kneel	Stoldyviæta
Keep	Harnq
Class	Klaso
Lazy	Yeneshka
Less	Anos
Lie	Dæsovs
Large	Vasel / Gratoshka
Life	Losonsko
Lead	Vaselek
Lord	Vraduma
Lady	Vradesma
Laugh	Dorma
Land / Area	Veslia
Learn	Uyesta / Sashema
Light	Ando
Least	Viano
Lavish	Gustarenska
Lifestyle	Losovsviyon
Left	Vealo
Little	Foko
Love	Zanzasto
Language	Geradyvia
Load	Gruza
Live	Mesanska
Luck	Udaza
Lost / Lose	Bavæt / Bavos
Like	Grozna
Low / Shallow	Tos
Look	Materna
Loud	Darmashka
Lexical	Laveshka
Letter	Brazmo
Law	Larvanta
Lay	Klazna
Lingual	Yaskova
Loss / Failure	Vozevna
Literal	Yeteral
Label	Masta
Logic	Rasona
Let	Prosna
Loyal / Fealty	Veærnæ
Lone	Odena
Late	Dovno
Lyric	Vashasudyvia
Link	Susdyvia
Liberty	Lebærtad
Lesson	Slushon
Long	Dayena
Mother	Valeda
Morning	Voskal
Meet	Niat
More	Kovrosta / Skavanto
Man	Vota
Most	Viadyvia / Skazeradyvia
Mood	Esana
Many	Yasveza
Meat	Meta
Maybe / Perhaps / Probably	Mozaksa
Mountain	Maten
Mercy	Mercia
Mix	Karaduzæv
Make / Cause	Zazera
Moon	Vunshtat
Military	Melatara
Majestic	Vazavalensha
Majesty	Vasavalezestva
Mistake	Suzero
Mean	Eshvredyviem
Main	Srazna
Move / Push	Dyviarmanto
Month	Mozka
March	Marzestamozka
May	Kamozka
Myth	Metema
Message	Mensiyas
Magnificent	Vastoza
Member	Serma
Mouth	Matema
Medic	Vemat
Metro / Subway	Metro
Medicine	Vestuzav
Mr / Sir	Vashka
Miss / Ma’am	Vastov
Much	Mnoga / Yarvesta
Mark	Okmæta
Mile	Melna
Milestone	Stovænyamotozka
Monolingual	Yasrezna
Multilingual	Yaskazna
Multiple	Dyviestkat
Matter	Rahanska
Moral	Dosevna
Method	Metod
Maintain	Upravedyviæ
Merit	Meranto
Motion	Dyvievosia
Magnify	Vasa
Magnifying Glass	Vasonvastashkasarovska
Mere	Prost
Metaphor	Metafor
Mock	Masnia
Modest	Modæsto
Mind	Mondo
Manger	Mangyor
Melody	Melodyvieva
Meditate	Medeteræn
Master / Skill / Fluent	Vriena
Mass	Mesa
Model	Modolo
Memory	Yestol
Muscle	Meatsa
Muscle Memory	Yesmedyvie
Monday	Montag
Never	Dyvievroma
Nature	Feora
Nation	Naselist
No / Nope	Dyvievæt
Number	Numerakos
Night / Tonight	Noredyvio
Nice	Sarshama
Nothing / None	Dyvievroska
Name	Numbra
Now	Sena / Nastiava / Sezasta
Noble	Egnia
North	Norvedyvia
Nobody / No one	Dyvievdæudyvia
Need	Vratovskar
November	Novelamozka
New	Novas
News [n]	Novasta
Note	Noshka
Narrow	Uske
Negotiate	Nægosion
Neighbor	Kasodyvie
Nativity	Hardeshno
Next	Astovna
Notification	Notefekasion
Nieche / Rare	Nesho
Okay / Yes	Za
Other / Another	Ustados
Our / We / Us	Und
Old	Kaza
Opinion	Oksanso
Only	Esmas
Own	Veska
Origin	Uzvorun
Open	Va
Order	Dormeta
Operation	Taovbia
Office	Ofesa
Oppose	Opozna / Sashen
Orchestra	Orhestra
October	Oktamozka
Ordain	Treando
Online	Elektro
Pronounce	Faldera
Problem	Tuzerma
Plagiarize	Galfar
Person / Hersona	Falatos
Piano	Feano
Prefer	Ferenta
Power	Enfera
Phrase	Sazaega
Part	Sorovskas
Pass [v]	Bremershka / Vasheska
Pass [n]	Rashevna
Paradise	Faradesemo
Pray	Krazar
Princess	Saredyvia
Pen	Venar / Vuzka
Politics	Volotek
Possible	Sasadyvia
Product	Trasanso
Pay	Maren / Plavet
Pawn	Trovadyvia
Pretend	Bretasus / Pretanto
Peace	Krazensa
Poor	Bezna
Put	Vesa
President	Vrasanter
Payback / Vengeance	Ashkanva
Parent	Brusketa
Perpetuate	Netarna
Prepare	Susama
Perfect	Sarvanto
Price	Sevrena
Please	Voztia
Pend	Vendæmo
Private	Brematærma
Photo	Foto
Pencil	Karandash
Penmanship	Vuzkasasa
Password	Prasærva
Proud	Proud
Planet	Planæta
Preposition	Prædos
Plan	Seyema
Proper	Prashema
Punish	Nakazat
Point	Greshema
Plow	Pashnia
Profit	Vegoda
Protect	Neshara
Play	Yayena
Present	Preseanta
Perceive / Conceive	Persevna
Police	Polatsar / Tosha
Pace	Pases
Palace	Valæsæa
Position	Posesion
Pain	Vradyviano
Pleasure	Plezanto
Publication	Publekasion
Print	Prento
Poem	Poyema
Pattern	Pqherno
Publish	Pazeto
Progress	Susnava
Paper	Vertungashlafa
Provide	Provendo
Promote	Promoto
Posterity	Prostæva
Program	Programo
Profile	Profeondo
Place	Preos
Posture	Postura
Party	Zaproshnæ
Puzzle	Prusholo
Practice	Prasvenye
Quick	Stava
Question / Inquiry / Ask	Somedyvie
Queen	Varedyvia
Quote / Cite	Serovat
Relate	Sveatsa
Right	Sealo
Reason	Krason
Rain	Aksonga / Radyvio
Regime	Ovrazem
Road	Bron
Read	Shveat
Real	Sevasa
Rule / Govern	Narsensa
Realm	Serino / Riq
Respect	Voshadyvia
Rip	Ravat / Kesens
Room	Yarina
Result	Seregna
Revenge	Eshkanven
Raisin	Sovaseska
Run	Lavna / Kezan
Rot / Rotten	Ketezæn
Rise / Raise	Ræna / Aræna
Rob	Tovaldyvia
Republic	Vestubeshka
Retire	Kashka
Regret	Sozanto
Reach	Sorva
Red	Raskanta
Regard	Æganto
Recent	Dyviædavna
Receive	Kræzevna
Restore	Abærmq
Review	Uzar
Remain	Almak
Ruin	Vasorena
Rank	Svamada
Reward	Nagrada
Rest	Ana
Retard	Ratando
Royal	Poroyono
Return	Vesta
Remember	Zotashnæ
Religion	Releseon
Rhyme	Rema
Recognize	Rashesta
Rendition	Rændecion
Reputation	Raputasion
Region	Ræando
Ready	Væando
Script	Karsia
Simple	Ovrodyvievan
Section	Vrengosta
Serene	Seredyvia
Serenism	Seredyviova
She / Her / Hers	Shvaes
Side	Zasta
Sun	Sundar
Strength	Strayesha
Same	Sevrata
Sleep	Duarma
Shut	Sakret / Breshna
Speak	Verena
Stupid	Sezadaher / Sezerma
Say / Tell	Skazat
Spend	Krozna
Square	Skazera
Spirit	Svadyvia
Son	Yanto
Sign	Sean
Sovereign	Saladyvios
Stretch	Striena
Style	Viyon
Shoot	Masa
Speed	Shesta
Subject	Suyano
School	Zamena / Shkola
Sad	Seaslan
Shit	Sayeza
Slay	Matas
Study	Kovas
Struggle	Zarveze
Some	Sovo
South	Votasha
See	Kesana
Sure	Sazar
Secret	Zastna
Small	Vagadyvia
Solar	Solvesta
Sore	Breshka
Stink	Avestama
Sin	Greshka
Sugar	Semera / Shugor
Sweet	Setadyvia
Syrup	Veruba
Sag	Seala
Strong	Strosha
Snow	Snovas
Summer	Astat / Yæta
Sea	Santa / Volma
Self	Stol
Scream	Vrustadyvia
Soldier	Soldatener
Social	Sosalo
Socialism	Sosalova
Ship	Skesa
Soon / Later	Armia
Safe	Matrovat
Special	Svezava
Sword	Sovroska
Shroud	Shvenda
Senate	Senatoreas
State	Susvedana
Serve	Servadyvia
System	Sestema
Snail	Salæva
Save	Salvæ
Song / Carol	Sudyvia
Sorry / Apologize / Apology	Sasvodyvia
Stop / Wait	Ostovana / Seta
September	Sementermozka
Several	Severanto
Server	Severma
Space	Svrazema / Spazedyvie
Structure	Sematorma
Sentence	Stroshærma / Senturon
Smart / Intelligent	Vestusha
Suck	Nava
Superb	Usta
Smell / Scent	Sozda
Suspicion	Vestusheas
Shame / Disgrace	Præstola
Swear	Dyvievtoma
Shop	Yadyviæ
Stone	Stova
Suffix	Sufeks
Size	Razmera
Single / Singular	Srezna
Stay	Ostatsa
Success	Sushest
Succeed / Triumph	Sushedyvia
Similar	Pokozne
Short	Piæta
Stick	Yavæta / Steshnia
Subordinate	Tosova
Society	Gravniadyvia
Scumbag	Braskedyvia
Show / Display	Kapazna
Signal	Seama
Season	Sezanto
Secure	Suzna
Stand	Stovana
Sincere	Eskrena
Strict	Strozedyvia
Sky	Skasa
Sell	Usasnæ
Soul	Solveshta
Serpent / Snake	Serpeænta
Saint	Sankt
Sister	Savratoshka
Still	Stela
Sneeze	Stazodyvia
Shoe	Zapatoshka
Summary / Overview	Yesuma
Spread	Spakashnæ
Symbol / Sigil	Sævono
Sing	Sovodyvioa
Situation	Setuyasa
Step	Staz
Stun / Taken-Aback	Astaza
Smile / Grin	Smiyano
Shine / Glisten	Sverkat
Scorn	Srashedyvia
Steal	Sarvato
Slander	Sloshdozna
Spouse	Venda
Sherpherd	Sana
Severe	Severa
Sick / Ill / Illness	Elnanto
Stanza	Stansa
Estore	Story
Sacrifice	Sakrefeso
Soft	Soshto
Subtle	Toshka
Source / Site	Vodozna
Sport	Dæpotæ
Spell	Spiyando
Spin	Dræhon
Saturday	Vundardyvio
Sunday	Sontrag
Test	Tesma
Term	Terma / Tuz
They / Them / Their	Valensha
Timber	Taesma
Tea	Te
Tire	Miyosk
Thanks / Thank you	Valesma
This / These	Vasesta
Tomorrow	Aradodyvia
Throne	Sarenshka / Prestova
Trespass	Treadyvia
Tempt	Malaesa
Then	Dason / Zestova
That / Those / Such	Uzena / Valeshæ
Temperature	Temperator
There	Tadyvia / Tam
Time	Tema
Try	Velyas
Think / Ponder	Vratiava
True	Yatva
Truth	Yatvan
Trick	Karva
Trip	Tovat
Train	Troza
Toast	Tavasemet
Tyranny	Terasdyvia
Than	Zæm
Terror	Vederzal
Treaty	Dovoroma
Thing / Stuff	Noradyvio
Take	Eshkenva / Ærma
Total	Votala
Tear	Tærva
Town	Sagraneza
Technical	Tezna
Terrible	Uzasne
Trash	Garbash
Table	Stola
Temper	Tempera
Trust	Vorat
Throat	Trono
Turn	Tronto
Tune	Tunæ
Tame	Tamno
Twirl	Vratuy
Throw	Verfun
Teach	Ushesto
Travel	Rasposto
Tradition	Tradesion
Thunder	Vrashenye
Tuesday	Yontrag
Thursday	Vqhand
Understand	Vashtera
Unite	Unesta
Union	Armesta
Use	Usas
Username	Usernama / Emyaposna
Ultimate	Ultemanto
Volunteer	Zalensker
Visit	Vasas
Very	Saes
Victory	Vetoria
Vote	Voltesa
Vomit	Komanda
Veil	Veltashka
Version	Version
Volcano	Varos
Verb	Svomada
Vocabulary	Vohansa
Virtue	Seva
Valley	Valar
Value	Viyanto
Vary	Vara
Vassal	Vasala
Vain	Noprasna
Verse	Versus
Voice	Vrusna
Vision	Veseon
Word	Vashenska
Who	Svaena
Will	Budæt
Water	Votærma
Watch	Vatum / Votrem
Well	Vata
War	Vodyvia / Velkrega
While	Kasen
What	Dasest
Why	Dasa / Notovka
Win	Estana
Write	Vroyovska
White	Veta / Dashna
Woman	Vomera
World	Kalesea / Vadyviæta
Wealth	Vetera
Which	Yanvo
Weak	Esheva
Want / Seek	Esadyvia
Where	Vos
West	Vasora
Work / Job	Trabadyvio
Wake	Afera
When	Vason
Welcome	Pozalavetsh
Wimp	Dasbadyvia
Way	Vusnava
Weapon	Sovradyvio
Wrong	Urma
Whore	Kurva
Wise	Skevadyvia
Wind	Venta
Winter	Venterasa
Weird / Odd / Duplicity	Vestushka
Week	Zempeorma
Weekend	Vezpeorma
Wine	Veno
Walk	Zaprosh
Wonder	Duma
Worth	Yadyvie
Wise	Vestova
Wide	Serozke
Wood	Vudama
Witch	Veshoska
Womb	Vundo
Wrist	Vres
Wed	Ve
Warm	Vridi
Wesnesday	Davesendo
You	Yarva
You’re Welcome	Tusleama
Year	Yavrena / Yavratama
Yesterday	Mearkena
Yes	Vaen / Za
Young	Yovan
